1111111111
1P000000E1
1011101001
1C00001001
1000110001
1C000000C1
1111111111